G G G W G G G G G G G G D C C C
G G G W W G G G G G G G D C C C
G G G G W G G G G G G D D C C C
G G G G W G G G G G G D G G G G
G G G W W G G G G G G D G G G G
G G G W G G G G G G G D G G G G
G G G D G G G G G G G D G G G G
G G G W G G G G G G D D G G G G
G G W W G G G G G G D G G G G G
G G W G G G G G G G D G G G D D
G G W G G G G G G G D G G G D D
G G W G G G G G G G D G G D D D